    changePokemonButton: "Trocar Pokémon",
    searchBattle: "Procurar batalha",

    wantToBattle: "Você quer começar uma batalha?",
    waitForPlayer: "Aguardando outro jogador...",

    noTeam: "Você não tem um time.",
    TeamFainted: "Pesquisar falhou. Todos seus pokémons estão desmaiados",

    // battle
    battlePlayerNotAccepted: "Seu oponente perdeu a conexão antes da batalha iniciar.<br><br>Por favor, tente de novo.",
    battleCancelled: "A batalha foi cancelada.",
    battleAlreadyEnded: "A batalha já acabou.",
    battleWaitForPlayer: "Esperando pelo outro jogador...",
    battleMoveUsed: (pokemonName, moveName) => `<span class="battle-log-pokemonname" style="color:#63ff78">${pokemonName}</span> usou <span class="battle-log-movename" style="color:#ff6374">${moveName}</span>.`,
    battleMoveFailed: "Falhou...",
    battleAttackMissed: (pokemonName) => `O ataque de <span class="battle-log-pokemonname" style="color:#63ff78">${pokemonName}</span> não acertou.`,
    battleNotEffective: "Não foi muito efetivo...",
    battleEffective: "Super efetivo!",
    battleNoEffect: "Não teve efeito nenhum...",
    battleCriticalHit: "Acerto crítico!",
    battleNotAwaitingMove: "O movimento já foi escolhido.",
    battleMultipleHits: (amount) => `${amount} acertos!`,
    battleStatUp1: (pokemonName, statName) => `${statName} do <span class="battle-log-pokemonname" style="color:#63ff78">${pokemonName}</span> aumentou.`,
    battleStatUp2: (pokemonName, statName) => ` ${statName} do <span class="battle-log-pokemonname" style="color:#63ff78">${pokemonName}</span> aumentou bruscamente!`,
    battleStatUp3: (pokemonName, statName) => `${statName} do <span class="battle-log-pokemonname" style="color:#63ff78">${pokemonName}</span> aumentou drasticamente!`,
    battleStatDown1: (pokemonName, statName) => `${statName} do <span class="battle-log-pokemonname" style="color:#63ff78">${pokemonName}</span> caiu.`,
    battleStatDown2: (pokemonName, statName) => `${statName} do <span class="battle-log-pokemonname" style="color:#63ff78">${pokemonName}</span> caiu demais!`,
    battleStatDown3: (pokemonName, statName) => `${statName} do <span class="battle-log-pokemonname" style="color:#63ff78">${pokemonName}</span> caiu severamente!`,

    // status effects
    battleEnemySleeping: (pokemonName) => `<span class="battle-log-pokemonname" style="color:#63ff78">${pokemonName}</span> adormeceu.`,
    battleEnemyParalysis: (pokemonName) => `<span class="battle-log-pokemonname" style="color:#63ff78">${pokemonName}</span> foi paralisado.`,
    battleEnemyPoison: (pokemonName) => `<span class="battle-log-pokemonname" style="color:#63ff78">${pokemonName}</span> foi envenenado.`,
    battleEnemyToxic: (pokemonName) => `<span class="battle-log-pokemonname" style="color:#63ff78">${pokemonName}</span> foi gravemente envenenado.`,
    battleEnemyBurned: (pokemonName) => `<span class="battle-log-pokemonname" style="color:#63ff78">${pokemonName}</span> está queimando.`,
    battleIsParalyzed: (pokemonName) => `<span class="battle-log-pokemonname" style="color:#63ff78">${pokemonName}</span> foi paralisado e não pode se mexer.`,
    battleEnemyConfused: (pokemonName) => `<span class="battle-log-pokemonname" style="color:#63ff78">${pokemonName}</span> ficou confuso`,
    battleEnemyEndConfusion: (pokemonName) => `<span class="battle-log-pokemonname" style="color:#63ff78">${pokemonName}</span> tirou a confusão fora`,
    battleEnemyFrozen: (pokemonName) => `<span class="battle-log-pokemonname" style="color:#63ff78">${pokemonName}</span> foi congelado`,
    battleIsSleeping: (pokemonName) => `<span class="battle-log-pokemonname" style="color:#63ff78">${pokemonName}</span> está dormindo e não pode se mexer.`,
    battleConfused: (pokemonName) => `<span class="battle-log-pokemonname" style="color:#63ff78">${pokemonName}</span> está confuso e bate em si mesmo.`,
    battleIsFrozen: (pokemonName) => `<span class="battle-log-pokemonname" style="color:#63ff78">${pokemonName}</span> está congelado e não consegue se mexer`,
    battleFlinched: (pokemonName) => `<span class="battle-log-pokemonname" style="color:#63ff78">${pokemonName}</span> vacilou e não pode atacar`,
    battleHealed: (pokemonName) => `<span class="battle-log-pokemonname" style="color:#63ff78">A vida de ${pokemonName}</span> foi atualizada.`,
    battleWokeUp: (pokemonName) => `O <span class="battle-log-pokemonname" style="color:#63ff78">${pokemonName}</span> acordou.`,
    battleUnthawed: (pokemonName) => `<span class="battle-log-pokemonname" style="color:#63ff78">${pokemonName}</span> se descongelou.`,
    battleRecoilApplied: (pokemonName) => `<span class="battle-log-pokemonname" style="color:#63ff78">${pokemonName}</span> tomou dano por recuar.`,
    battlePoisonDamage: (pokemonName) => `<span class="battle-log-pokemonname" style="color:#63ff78">${pokemonName}</span> tomou dano de veneno.`,
    battleBurnDamage: (pokemonName) => `<span class="battle-log-pokemonname" style="color:#63ff78">${pokemonName}</span> tomou dano de queimadura.`,
    battlePokemonChanged: (LastPokemonName, CurrentPokemonName) => `<span class="battle-log-pokemonname" style="color:#63ff78">${LastPokemonName}</span> foi trocado por <span class="battle-log-pokemonname" style="color:#63ff78">${CurrentPokemonName}</span>.`,

    // field effects
    battleRainEnd: `Parou de chover`,
    battleRainStarted: `Começou a chover`,
    battleHailStarted: `Começou a chover granizo`,
    battleHailDamage: 'O pokémon tomou dano do granizo.',
    battleHailEnd: 'A chuve de granizo parou.',
    battleSandstormStarted: "Uma tempestade de areia começou",
    battleSandstormDamage: "O pokémon sofreu dano pela tempestade de areia.",
    battleSandstormEnd: "A tempestade de areia terminou.",
    battleSunStarted: `O sol brilha reluzente.`,
    battleSunEnd: `O sol desapareceu.`,

    // battle ended
    BattleWin: "Meus parabéns, você ganhou a batalha!",
    BattleLose: "Você perdeu a batalha!",
    BattleXP: (XP) => `Seu time ganhou ${XP} de experiência!`,
    BattleNoXP: "Seu time não ganhou nenhuma EXP!",
